 ###################P
 #........#........# 
 #o##.###.#.###.##o# 
 #.................# 
 #.##.#.#####.#.##.# 
 #....#...#...#....# 
 ####.### E ###.#### 
    #.#   b   #.#    
#####.# ##=## #.#####
  B  .  #ipc#  .     
#####.# ##### #.#####
    #.#       #.#    
 ####.# ##### #.#### 
 #........#........# 
 #.##.###.#.###.##.# 
 #o.#.....K.....#.o# 
 ##.#.#.#####.#.#.## 
 #....#...#...#....# 
 #.######.#.######.# 
 #.................# 
I###################C
