B###################P
 #........#........# 
 #o##.###.#.###.##o# 
 #.................# 
 #.##.#.#####.#.##.# 
 #....#...#...#....# 
 ####0### E ###.#### 
    #.#   b   #.#    
#####.# ##=## #.#####
     .  #ipc#  .     
#####.# ##### #.#####
    #.#       #.#    
 ####0# ##### #.#### 
 #........#........# 
 #.##.###.#.###.##.# 
 #o.#.....K.....#.o# 
 ##.#.#.#####.#.#.## 
 #....#...#...#....# 
 #.######.#.######.# 
 #.................# 
I###################C
