####################P
#########.#ipbc.....# 
#########.#.###.##o# 
#########..........# 
#############.#.##.# 
#########.#...#....# 
######### E ###.#### 
######### #   #.#    
##########=## #.#####
############  .     
############# #.#####
#########     #.#    
############# #.#### 
#########.#........# 
#########.#.###.##.# 
#########.K.....#.o# 
#############.#.#.## 
#########.#...#....# 
#########.#.######.# 
#########..........# 
####################C
